################
#..............#
#..............#
#..##A####B##..#
#..............#
#.......A......#
#..............#
#.......D......#
#............T.#
#.......B......#
#..............#
################
